#################
#i.G..c.#.e..H.p#
#######.#.#######
#j.A..b...f..D.o#
#######.@.#######
#k.E..a...g..B.n#
#######.#.#######
#l.F..d.#.h..C.m#
#################
